111111111111111111111
100000000000000000001
100010100000000100011
1P001E100000000000001
111111111111111111111