R 850 500
NO ./assets/crystal.xpm
SO ./assets/crystal_imac.xpm
WE ./assets/crystal_box.xpm
EA ./assets/crystal_sign.xpm
S ./assets/vlc.xpm
F 0,0,0
C 0,0,0

HK ./assets/healthkit.xpm
PORTAL ./assets/portal.xpm
DOOR ./assets/door.xpm
GOOMBA ./assets/goomba.xpm
SKYBOX ./assets/skybox.xpm
FLOOR ./assets/stone.xpm
DASH ./assets/dash.xpm
GUN ./assets/portalgun.xpm

S_DOOR ./assets/door.mp3
S_HURT ./assets/hurt.mp3
S_STOMP ./assets/stomp.mp3
S_PORTAL ./assets/portal.mp3
S_HEAL ./assets/heal.mp3
S_WALK ./assets/walk.mp3
S_AMBIENT ./assets/background.mp3

111111111111111
100000100000001
100S0011111111111111111111
10000012000000000000010001
10000010000000000G000D0001
10000012000000000000010001
111D1111111D11111111110001
110000110000001      10001
100000010000001      10001
100000010000001      10001
1000000D000000111111111D11111111111
10000001000000100000000000000000001
100000010000001000000000000000000011111
110000110000001001110000000000110010001
111111111111111001G00000000000G10010001
              1000000000000000000010001
              1000000000000000000010001
              10000000000000000000D0001
              1000000000000000000010001
              1000000000000000000010001
              1001G00000000000G10010001
              1001100000000000110010001
              1000000000000000000010001
              1000000000000000000010001
              1111111111111111111110001
                                  10001
                               11110001111
                               10000000001
   1111111111111               10000000001
   1000000000001               10000000001
   1000000000001               10000000001
   10000G000G001               10000000001
   1000000000001               10H00000H01
   1000000000001               10000000001
   10011111111111111111111     11111D11111
   100D0000000000000000001       100001
   11110000000000000000001       100001
      10000000000000000001       100001
  11111000000000000111D1111111111100001
  1000D00G00000G00010000000000000000001
  1000100000000000010000000000000000001
  1000100000000000010000000000000000001
  1000111111D11111110000000000000000001
  1000000010G01    111D1111111111111111
  1000000010001    100000000001
  1000000010001    100000000001
  1111211110001    100G00000001
    10001 10201    100000000001
    10001111111    10000G000001
    10000000001    100000000001
    11111100001    111111011111
         110001        10001
          10001        10001
           10001       1H201
            10001      11111
             10001
              10001
               10001
                10001111111111111111111111111111111111111
                10000010001000001000000010000000001010001
                11101010101011101011101110111011101011101
                10001000101010101000100000101010000000001
                10101110111110101111111010101110111111111
                10101010100000000010000010100010100010001
                10111011111111111010111110101111111010101
                10101010001000001010000010000010100000101
                10101010101110111011101011111110111111101
                10000010101000001000001010100010001000001
                10101010111111101110111110101111101011101
                10101000000010000010000000000010000000101
                11101010111110111010101011101110111111111
                10101010000000100000101000100000100000001
                10101110111010111010101111111110101111101
                10001000001010001010101000000010000010101
                10111011101110101011111011101110111010101
                10100010001010101000001000100010001010101
                10111010101011101111101011101111101010101
                10100010101000101000100000100010101010001
                10111010101110101110101011111110111011101
                10101010100000101000001000100010001010101
                10101110101111111110101111101110101010101
                10001000100010000000100010000010101010101
                10101011101010101111111110111110111010111
                10101010001010100000000000100000100010001
                10101011111011111111111110101111111111101
                10101000101000001000001000101000001000001
                11101110101111111010111110101010111011111
                10001000000010000010100010000010100000001
                10111111111011101010101111111110111111101
                10100000001000001010000010000010001010001
                11101010111110111011111010111111101010101
                10001010100000100000001010100000100010101
                10101110101011101111101110101110111010111
                10101000101010000010000010001000000010001
                10101011101010111011111111111010111010101
                10101000001010101000000000001010001000101
                1010111111101010101110111110101110111110111111111
                101000001000100010100000001010100000001PD00000001
                1111111111111111111111111111111111111111100000001
                                                        100000001
                                                        1000G0001
                                                        100000001
                                                        1000H0001
                                                        111111111
