111111111111
100P0000C001
10000C00C001
100\n0000001
100000000E11
111111111111