11111111111111
1PC111111100E1
100000C000C001
11111111111111