1111111
1P00001
1000C01
1C00111
100C001
11100E1
1111111