1111111
10P0001
1100C01
10C0001
1E000E1
1111111